[console_scripts]
nbpy-pub-betfair-stream = nbpy.zmq.publishers.betfair_stream:main
nbpy-pub-kraken-EURUSD = nbpy.zmq.publishers.kraken_EURUSD:main
nbpy-pub-kraken-EURUSD-depth = nbpy.zmq.publishers.kraken_EURUSD_depth:main
nbpy-pub-kraken-EURUSD-tick = nbpy.zmq.publishers.kraken_EURUSD_tick:main
nbpy-pub-kraken-depth = nbpy.zmq.publishers.kraken_depth:main
nbpy-pub-kraken-orders = nbpy.zmq.publishers.kraken_orders:main
nbpy-pub-kraken-tick = nbpy.zmq.publishers.kraken_tick:main
nbpy-pub-oanda = nbpy.zmq.publishers.oanda:main
nbpy-pub-oanda-orders = nbpy.zmq.publishers.oanda_orders_:main
nbpy-pub-oanda-tick = nbpy.zmq.publishers.oanda_tick:main
nbpy-pub-oandav20-tick = nbpy.zmq.publishers.oandav20_tick:main
nbpy-pub-oandav20-tick-topic = nbpy.zmq.publishers.oandav20_tick_topic:main
nbpy-sub-influxdb-tick = nbpy.zmq.subscribers.influxdb_tick:main
nbpy-sub-kraken-EURUSD = nbpy.zmq.subscribers.kraken_EURUSD:main
nbpy-sub-kraken-EURUSD-basket = nbpy.zmq.subscribers.kraken_EURUSD_basket:main
nbpy-sub-kraken-EURUSD-depth = nbpy.zmq.subscribers.kraken_EURUSD_depth:main
nbpy-sub-kraken-EURUSD-depth-send-order = nbpy.zmq.subscribers.kraken_EURUSD_depth_send_order:main
nbpy-sub-kraken-EURUSD-pgsql-tick = nbpy.zmq.subscribers.kraken_EURUSD_pgsql_tick:main
nbpy-sub-kraken-EURUSD-tick-grakn = nbpy.zmq.subscribers.kraken_EURUSD_tick_grakn:main
nbpy-sub-kraken-EURUSD-tick-influxdb = nbpy.zmq.subscribers.kraken_EURUSD_tick_influxdb:main
nbpy-sub-kraken-EURUSD-tick-pgsql = nbpy.zmq.subscribers.kraken_EURUSD_tick_pgsql:main
nbpy-sub-kraken-basic-stat-influxdb-tick = nbpy.zmq.subscribers.kraken_basic_stat_influxdb_tick:main
nbpy-sub-kraken-basic-stat-tick-cuda = nbpy.zmq.subscribers.kraken_basic_stat_tick_cuda:main
nbpy-sub-kraken-basic-stat-tick-pd = nbpy.zmq.subscribers.kraken_basic_stat_tick_pd:main
nbpy-sub-kraken-influxdb = nbpy.zmq.subscribers.kraken_influxdb:main
nbpy-sub-kraken-influxdb-EURUSD-basket = nbpy.zmq.subscribers.kraken_influxdb_EURUSD_basket:main
nbpy-sub-kraken-influxdb-depth = nbpy.zmq.subscribers.kraken_influxdb_depth:main
nbpy-sub-kraken-influxdb-depth-base-term = nbpy.zmq.subscribers.kraken_influxdb_depth_base_term:main
nbpy-sub-kraken-influxdb-orders = nbpy.zmq.subscribers.kraken_influxdb_orders:main
nbpy-sub-kraken-influxdb-tick = nbpy.zmq.subscribers.kraken_influxdb_tick:main
nbpy-sub-kraken-kapacitor-EURUSD = nbpy.zmq.subscribers.kraken_kapacitor_EURUSD:main
nbpy-sub-kraken-kapacitor-orders = nbpy.zmq.subscribers.kraken_kapacitor_orders:main
nbpy-sub-oanda-influxdb = nbpy.zmq.subscribers.oanda_influxdb:main
nbpy-sub-oanda-influxdb-tick = nbpy.zmq.subscribers.oanda_influxdb_tick:main
nbpy-sub-oanda-kraken-EURUSD-depth-position-order = nbpy.zmq.subscribers.oanda_kraken_EURUSD_depth_position_order:main
nbpy-sub-oanda-kraken-EURUSD-depth-position-order-update = nbpy.zmq.subscribers.oanda_kraken_EURUSD_depth_position_order_update:main
nbpy-sub-oanda-kraken-EURUSD-tick-position-order = nbpy.zmq.subscribers.oanda_kraken_EURUSD_tick_position_order:main
nbpy-sub-oanda-pgsql-tick = nbpy.zmq.subscribers.oanda_pgsql_tick:main
nbpy-sub-twitter-influx-sentiment-location = nbpy.zmq.subscribers.twitter_influx_sentiment_location:main
nbpy-sub-twitter-pgsql-sentiment-location = nbpy.zmq.subscribers.twitter_pgsql_sentiment_location:main
